WWWWWWWWWWWWWWW
WW----M-------W
W----WWWWW----W
WW--WWWWWWWWWTW
WW-----WWWWWWWW
WWW----------WW
WWWW---E--WWWWW
WWW----W----WWW
WW--WWWWW----WW
WW--N-WWWWW---W
WWW----------WW
WWWW--WW----WWW
WWW--W---WWWWWW
WWWWWW--WWWWWWW
WWWWWWGWWWWWWWW